....................
....................
....................
....................
....................
..............GG....
..............##....
...........##.......
.........##.........
.......##...........
.....##.............
...##...............
....................
.1................X.
####################