....................
....................
..................X.
....################
..G.................
###...G.G.G.G.......
.......G.G.GCG......
......--------......
...--...........--..
....................
.G.G............GGG.
####...G.....G..####
......GGG...GGG.....
.1...GGGGG.GGGGG....
####################