....................
....................
....................
....................
....................
....................
....................
....................
....................
......X.............
.....##.............
...##...............
....................
.1...G.G.G.G......G
##### # # # # ######