....................
....................
....................
...--..........--...
.G................X.
..G...G.G.G.G....###
.G.....G.G.GBG......
..G...--------......
................--..
....................
AG.G.D..............
##########.....#####
....................
.1..GGGGGGGG..GGGCGG
#############.######