....................
....................
....................
....................
....................
....................
....................
....................
....................
...GGGG.G...G.GGGG..
...G.....G.G..G..G..
...GGG....G...G..G..
...G.....G.G..G..G..
.1.G....G...G.GGGGX.
####################