....................
....................
....................
......GGGGDGCGGG....
......----------....
....................
##............------
..A.................
..##................
.......##...........
....................
...##...............
....................
.1................X.
###...............##