.................X..
.................--.
...C................
..--................
....................
..G............GG...
..##..........##....
....................
.......GB...........
.......##...........
................A...
...............--...
....##..............
.1..................
###.................